000000010000000
000000000000000
000000000000000
000100000000000
111100010000000
000000001000001
000000000100001
000000000010001
000100000010000
111100000010000
000000000010000
000000000000000
000000000000001
000000000000001
000000000000001
000000000000000
000001111110000
000000000000000
000000000000000
000000000000000
